ALL-US	Acute_Lymphoblastic_Leukemia_-_TARGET,_US	US
AML-US	Acute_Myeloid_Leukemia_-_TARGET,_US	US
BLCA-CN	Bladder_Urothelial_carcinoma_-_CN	China
BLCA-US	Bladder_Urothelial_Cancer_-_TGCA,_US	US
BOCA-FR	Bone_Cancer_-_Ewing_Sarcoma_-_FR	France
BOCA-UK	Bone_Cancer_-_UK	United_Kingdom
BRCA-CN	Breast_Triple_Negative_Cancer_-_CN	China
BRCA-EU	Breast_ER+_and_HER2-_Cancer_-_EU/UK	European_Union/United_Kingdom
BRCA-FR	Breast_Cancer_-_FR	France
BRCA-KR	Breast_Cancer_-_KR	South_Korea
BRCA-MX	Breast_Cancer_-_SIGMA,_MX	Mexico
BRCA-UK	Breast_Triple_Negative/Lobular_Cancer_-_UK	United_Kingdom
BRCA-US	Breast_Cancer_-_TCGA,_US	US
BTCA-JP	Biliary_tract_cancer_-_JP	Japan
BTCA-SG	Biliary_tract_cancer_-_Gall_bladder_cancer/Cholangiocarcinoma_-_SG	Singapore
CCSK-US	Clear_Cell_Sarcomas_of_the_Kidney_-_TARGET,_US	US
CESC-US	Cervical_Squamous_Cell_Carcinoma_-_TCGA,_US	US
CLLE-ES	Chronic_Lymphocytic_Leukemia_-_ES	Spain
CMDI-UK	Chronic_Myeloid_Disorders_-_UK	United_Kingdom
COAD-US	Colon_Adenocarcinoma_-_TCGA,_US	US
COCA-CN	Colorectal_Cancer_-_CN	China
DLBC-US	Lymphoid_Neoplasm_Diffuse_Large_B-cell_Lymphoma_-_TCGA,_US	US
EOPC-DE	Early_Onset_Prostate_Cancer_-_DE	Ger
ESAD-UK	Esophageal_Adenocarcinoma_-_UK	United_Kingdom
ESCA-CN	Esophageal_Cancer_-_CN	China
GACA-CN	Gastric_Cancer_-_CN	China
GBM-CN	Glioblastoma_multiforme_-_CN	China
GBM-US	Brain_Glioblastoma_Multiforme_-_TCGA,_US	US
HNCA-MX	Head_and_Neck_Cancer_-_SIGMA,_MX	Mexico
HNSC-US	Head_and_Neck_Squamous_Cell_Carcinoma_-_TCGA,_US	US
KICH-US	Kidney_Chromophobe_-_TCGA,_US	US
KIRC-US	Kidney_Renal_Clear_Cell_Carcinoma_-_TCGA,_US	US
KIRP-US	Kidney_Renal_Papillary_Cell_Carcinoma_-_TCGA,_US	US
LAML-CN	Acute_myeloid_leukaemia_and_Chronic_myelogenous_leukaemia	China
LAML-KR	Acute_Myeloid_Leukemia_-_KR	South_Korea
LAML-US	Acute_Myeloid_Leukemia_-_TCGA,_US	US
LGG-US	Brain_Lower_Grade_Glioma_-_TCGA,_US	US
LIAD-FR	Benign_Liver_Tumour_-_FR	France
LICA-CN	Liver_Cancer_-_CN	China
LICA-FR	Liver_Cancer_-_FR	France
LIHC-US	Liver_Hepatocellular_carcinoma_-_TCGA,_US	US
LIHM-FR	Liver_Hepatocellular_Macronodules_-_FR	US
LINC-JP	Liver_Cancer_-_NCC,_JP	Japan
LIRI-JP	Liver_Cancer_-_RIKEN,_JP	Japan
LMS-FR	Soft_tissue_cancer_-_Leiomyosarcoma_-_FR	France
LUAD-US	Lung_Adenocarcinoma_-_TCGA,_US	US
LUSC-CN	Lung_Squamous_cell_carcinoma_-_CN	China
LUSC-KR	Lung_Cancer_-_Squamous_cell_carcinoma_-_KR	South_Korea
LUSC-US	Lung_Squamous_Cell_Carcinoma_-_TCGA,_US	US
MALY-DE	Malignant_Lymphoma_-_DE	Germany
MELA-AU	Skin_Cancer_-_AU	Australia
NACA-CN	Nasopharyngeal_cancer_-_CN	China
NBL-US	Neuroblastoma_-_TARGET,_US	US
NHLY-MX	Non_Hodgkin_Lymphoma_-_SIGMA,_MX	Mexico
ORCA-IN	Oral_Cancer_-_IN	India
OS-US	Osteosarcoma_-_TARGET,_US	US
OV-AU	Ovarian_Cancer_-_AU	Australia
OV-CN	Ovarian_cancer_-_CN	China
OV-US	Ovarian_Serous_Cystadenocarcinoma_-_TCGA,_US	US
PAAD-US	Pancreatic_Cancer_-_TCGA,_US	US
PACA-AU	Pancreatic_Cancer_Endocrine_Neoplasms-_AU	Australia
PACA-CA	Pancreatic_Cancer_-_CA	Canada
PACA-CN	Pancreatic_Ductal_adenocarcinoma_-_CN	China
PAEN-AU	Pancreatic_Cancer_Endocrine_neoplasms_-_AU	Australia
PAEN-IT	Pancreatic_Endocrine_Neoplasms-_IT	Italy
PBCA-DE	Pediatric_Brain_Cancer_-_DE	Germany
PEME-CA	Pediatric_Medulloblastoma_-_CA	Canada
PRAD-CA	Prostate_Adenocarcinoma_-_CA	Canada
PRAD-FR	Prostate_Cancer_-_Adenocarcinoma_-_FR	France
PRAD-CN	Prostate_cancer_-_CN	China
PRAD-UK	Prostate_Adenocarcinoma_-_UK	United_Kingdom
PRAD-US	Prostate_Adenocarcinoma_-_TCGA,_US	US
PRCA-FR	Prostate_cancer_-_Adenocarcinoma_-_FR	France
READ-US	Rectum_Adenocarcinoma_-_TCGA,_US	US
RECA-CN	Renal_clear_cell_carcinoma_-_CN	China
RECA-EU	Renal_Cell_Cancer_-_EU/FR	European_Union/France
RT-US	Rhabdoid_Tumors_-_TARGET,_US	US
RTBL-FR	Eye_cancer_-_Retinoblastoma_-_FR	France
SARC-US	Sarcoma_-_TCGA,_US	US
SKCA-BR	Skin_Adenocarcinoma_-_BR	Brazil
SKCM-US	Skin_Cutaneous_melanoma_-_TCGA,_US	US
STAD-US	Gastric_Adenocarcinoma_-_TCGA,_US	US
THCA-CN	Thyroid_papillary_carcinoma_-_CN	China
THCA-SA	Thyroid_Cancer_-_SA	Saudi_Arabia
THCA-US	Head_and_Neck_Thyroid_Carcinoma_-_TCGA,_US	US
UTCA-FR	Uterine_Cancer_-_Carcinosarcoma_-_FR	France
UCEC-US	Uterine_Corpus_Endometrial_Carcinoma-_TCGA,_US	US
WT-US	Wilms_Tumor_-_TARGET,_US	US